[
    [
        [" ", " ", " ", " ", " ", " ", " ", " ", " ", " ", " ", " ", " ", " ", " ", " ", " ", " ", " ", " ", " ", " ", " ", " ", " ", " ", " ", " ", " ", " ", " ", " "],
        [" ", " ", " ", " ", " ", " ", " ", " ", " ", " ", " ", " ", " ", " ", " ", " ", " ", " ", " ", " ", " ", " ", " ", " ", " ", " ", " ", " ", " ", " ", " ", " "],
        [" ", " ", " ", " ", " ", " ", " ", " ", " ", "l", " ", " ", " ", " ", " ", " ", " ", " ", " ", " ", " ", " ", " ", " ", " ", " ", " ", " ", " ", " ", " ", " "],
        ["f", "f", "f", "f", "f", "f", "f", "f", "f", "l", "f", "f", "f", "f", "f", " ", " ", " ", " ", " ", " ", " ", " ", " ", " ", " ", " ", " ", " ", " ", " ", " "],
        [" ", " ", " ", " ", " ", " ", " ", " ", " ", "l", " ", " ", " ", " ", " ", " ", " ", " ", " ", " ", " ", " ", " ", " ", " ", " ", " ", " ", " ", " ", " ", " "],
        [" ", " ", " ", " ", " ", " ", " ", " ", " ", "l", " ", " ", " ", " ", " ", " ", " ", " ", " ", " ", " ", " ", " ", " ", " ", " ", " ", " ", " ", " ", " ", " "],
        [" ", " ", " ", " ", " ", " ", " ", " ", " ", "l", " ", " ", " ", " ", " ", " ", " ", " ", " ", " ", " ", " ", " ", " ", " ", " ", " ", " ", " ", " ", " ", " "],
        [" ", " ", " ", " ", " ", " ", " ", " ", " ", "l", " ", " ", " ", " ", " ", " ", " ", " ", " ", "l", " ", " ", "e", " ", " ", " ", " ", " ", " ", " ", " ", " "],
        [" ", " ", " ", " ", " ", " ", " ", " ", " ", "l", " ", " ", " ", " ", " ", " ", " ", " ", " ", "l", "f", "f", "f", "f", "f", "f", " ", " ", " ", " ", " ", " "],
        [" ", " ", " ", " ", " ", " ", " ", " ", " ", "l", " ", " ", " ", " ", " ", " ", " ", " ", " ", "l", " ", " ", " ", " ", " ", " ", " ", " ", " ", " ", " ", " "],
        [" ", " ", " ", " ", " ", " ", " ", " ", " ", "l", " ", " ", " ", " ", " ", " ", " ", " ", " ", "l", " ", " ", " ", " ", " ", " ", " ", " ", " ", " ", " ", " "],
        [" ", " ", " ", " ", " ", " ", " ", " ", " ", "l", " ", " ", " ", " ", " ", " ", " ", " ", " ", "l", " ", " ", " ", " ", " ", " ", " ", " ", " ", " ", " ", " "],
        [" ", " ", " ", " ", " ", " ", " ", " ", " ", "l", " ", " ", " ", " ", " ", " ", " ", " ", " ", "l", " ", " ", " ", " ", " ", " ", " ", " ", " ", " ", " ", " "],
        [" ", " ", " ", " ", " ", " ", " ", " ", " ", "l", " ", " ", " ", " ", " ", " ", " ", " ", " ", "l", " ", " ", " ", " ", " ", " ", " ", " ", " ", " ", " ", " "],
        [" ", " ", "s", " ", " ", " ", " ", " ", " ", "l", " ", " ", " ", " ", "e", " ", " ", " ", " ", "l", " ", " ", " ", " ", " ", " ", " ", " ", " ", "p", " ", " "],
        ["f", "f", "f", "f", "f", "f", "f", "f", "f", "f", "f", "f", "f", "f", "f", "f", "f", "f", "f", "f", "f", "f", "f", "f", "f", "f", "f", "f", "f", "f", "f", "f"],
        ["f", "f", "f", "f", "f", "f", "f", "f", "f", "f", "f", "f", "f", "f", "f", "f", "f", "f", "f", "f", "f", "f", "f", "f", "f", "f", "f", "f", "f", "f", "f", "f"],
        ["f", "f", "f", "f", "f", "f", "f", "f", "f", "f", "f", "f", "f", "f", "f", "f", "f", "f", "f", "f", "f", "f", "f", "f", "f", "f", "f", "f", "f", "f", "f", "f"]
    ],
    [
        [" ", " ", " ", " ", " ", " ", " ", " ", " ", " ", " ", " ", " ", " ", " ", " ", " ", " ", " ", " ", " ", " ", " ", " ", " ", " ", " ", " ", " ", " ", " ", " "],
        [" ", " ", " ", " ", " ", " ", " ", " ", " ", " ", " ", " ", " ", " ", " ", " ", " ", " ", " ", " ", " ", " ", " ", " ", " ", " ", " ", " ", " ", " ", " ", " "],
        [" ", " ", " ", " ", " ", " ", " ", " ", " ", " ", " ", " ", " ", " ", " ", " ", " ", " ", " ", " ", " ", " ", " ", " ", " ", " ", " ", " ", " ", " ", " ", " "],
        [" ", " ", " ", " ", " ", " ", " ", " ", " ", " ", " ", " ", " ", " ", " ", " ", " ", " ", " ", " ", " ", " ", " ", " ", " ", " ", " ", " ", " ", " ", " ", " "],
        [" ", " ", " ", " ", " ", " ", " ", " ", " ", " ", " ", " ", " ", " ", " ", " ", " ", " ", " ", " ", " ", " ", " ", " ", " ", " ", " ", " ", " ", " ", " ", " "],
        [" ", " ", " ", " ", " ", " ", " ", " ", " ", " ", " ", " ", " ", " ", " ", " ", " ", " ", " ", " ", " ", " ", " ", " ", " ", " ", " ", " ", " ", " ", " ", " "],
        [" ", " ", " ", " ", " ", " ", " ", " ", " ", " ", " ", " ", " ", " ", " ", " ", " ", " ", " ", " ", " ", " ", " ", " ", " ", " ", " ", " ", " ", " ", " ", " "],
        [" ", " ", " ", " ", " ", " ", " ", " ", " ", " ", " ", " ", " ", " ", " ", " ", " ", " ", " ", " ", " ", " ", " ", " ", " ", " ", " ", " ", " ", " ", " ", " "],
        [" ", " ", " ", " ", " ", " ", " ", " ", " ", " ", " ", " ", " ", "l", " ", " ", " ", " ", " ", " ", " ", " ", " ", " ", " ", " ", " ", " ", " ", " ", " ", " "],
        ["f", "f", "f", "f", "f", "f", "f", "f", "f", "f", "f", "f", "f", "l", " ", " ", " ", " ", " ", " ", " ", " ", " ", " ", " ", " ", " ", " ", " ", " ", " ", " "],
        [" ", " ", " ", " ", " ", " ", " ", " ", " ", " ", " ", " ", " ", "l", " ", " ", " ", " ", " ", " ", " ", " ", " ", " ", " ", " ", " ", " ", " ", " ", " ", " "],
        [" ", " ", " ", " ", " ", " ", " ", " ", " ", " ", " ", " ", " ", "l", " ", " ", " ", " ", " ", " ", " ", " ", " ", " ", " ", " ", " ", " ", " ", " ", " ", " "],
        [" ", " ", " ", " ", " ", " ", " ", " ", " ", " ", " ", " ", " ", "l", " ", " ", " ", " ", " ", " ", " ", " ", " ", " ", " ", " ", " ", " ", " ", " ", " ", " "],
        [" ", " ", " ", " ", " ", " ", " ", " ", " ", " ", " ", " ", " ", "l", " ", " ", " ", " ", " ", " ", " ", " ", " ", " ", " ", " ", " ", " ", " ", " ", " ", " "],
        [" ", "p-", " ", "s", " ", " ", " ", " ", " ", " ", " ", " ", " ", "l", " ", " ", " ", " ", " ", " ", "e", " ", " ", " ", " ", "e", " ", " ", " ", " ", " ", " "],
        ["f", "f", "f", "f", "f", "f", "f", "f", "f", "f", "f", "f", "f", "f", "f", "f", "f", "f", "f", "f", "f", "f", "f", "f", "f", "f", "f", "f", "f", "f", "f", "f"],
        ["f", "f", "f", "f", "f", "f", "f", "f", "f", "f", "f", "f", "f", "f", "f", "f", "f", "f", "f", "f", "f", "f", "f", "f", "f", "f", "f", "f", "f", "f", "f", "f"],
        ["f", "f", "f", "f", "f", "f", "f", "f", "f", "f", "f", "f", "f", "f", "f", "f", "f", "f", "f", "f", "f", "f", "f", "f", "f", "f", "f", "f", "f", "f", "f", "f"]
    ]
    
]