[
    [
        [" ", " ", " ", " ", " ", " ", " ", " ", " ", " ", " ", " ", " ", " ", " ", " ", " ", " ", " ", " ", " ", " ", " ", " ", " ", " ", " ", " ", " ", " ", " ", " "],
        [" ", " ", " ", " ", " ", " ", " ", " ", " ", " ", " ", " ", " ", " ", " ", " ", " ", " ", " ", " ", " ", " ", " ", " ", " ", " ", " ", " ", " ", " ", " ", " "],
        [" ", "p", "e", " ", " ", " ", " ", " ", " ", "l", " ", " ", " ", " ", " ", " ", " ", " ", " ", " ", " ", " ", " ", " ", " ", " ", " ", " ", " ", " ", " ", " "],
        ["f", "f", "f", "f", "f", "f", "f", "f", "f", "l", "f", "f", "f", "f", "f", " ", " ", " ", " ", " ", " ", " ", " ", " ", " ", " ", " ", " ", " ", " ", " ", " "],
        [" ", " ", " ", " ", " ", " ", " ", " ", " ", "l", " ", " ", " ", " ", " ", " ", " ", " ", " ", " ", " ", " ", " ", " ", " ", " ", " ", " ", " ", " ", " ", " "],
        [" ", " ", " ", " ", " ", " ", " ", " ", " ", "l", " ", " ", " ", " ", " ", " ", " ", " ", " ", " ", " ", " ", " ", " ", " ", " ", " ", " ", " ", " ", " ", " "],
        [" ", " ", " ", " ", " ", " ", " ", " ", " ", "l", " ", " ", " ", " ", " ", " ", " ", " ", " ", " ", " ", " ", " ", " ", " ", " ", " ", " ", " ", " ", " ", " "],
        [" ", " ", " ", " ", " ", " ", " ", " ", " ", "l", " ", " ", " ", " ", " ", " ", " ", " ", " ", "l", " ", " ", "e", " ", " ", " ", " ", " ", " ", " ", " ", " "],
        [" ", " ", " ", " ", " ", " ", " ", " ", " ", "f", "f", "f", "f", "f", "f", "f", "f", "f", "f", "l", "f", "f", "f", "f", "f", "f", "f", "f", "f", "f", "f", "f"],
        [" ", " ", " ", " ", " ", " ", " ", " ", " ", " ", " ", " ", " ", " ", " ", " ", " ", " ", " ", "l", " ", " ", " ", " ", " ", " ", " ", " ", " ", " ", " ", " "],
        [" ", " ", " ", " ", " ", " ", " ", " ", " ", " ", " ", " ", " ", " ", " ", " ", " ", " ", " ", "l", " ", " ", " ", " ", " ", " ", " ", " ", " ", " ", " ", " "],
        [" ", " ", " ", " ", " ", " ", " ", " ", " ", " ", " ", " ", " ", " ", " ", " ", " ", " ", " ", "l", " ", " ", " ", " ", " ", " ", " ", " ", " ", " ", " ", " "],
        [" ", " ", " ", " ", " ", " ", " ", " ", " ", " ", " ", " ", " ", " ", " ", " ", " ", " ", " ", "l", " ", " ", " ", " ", " ", " ", " ", " ", " ", " ", " ", " "],
        [" ", " ", " ", " ", " ", " ", " ", " ", " ", " ", " ", " ", " ", " ", " ", " ", " ", " ", " ", "l", " ", " ", " ", " ", " ", " ", " ", " ", " ", " ", " ", " "],
        [" ", " ", "s", " ", " ", " ", " ", " ", " ", " ", " ", " ", " ", " ", "e", " ", " ", " ", " ", "l", " ", "e", " ", " ", " ", " ", " ", "e", " ", " ", " ", " "],
        ["f", "f", "f", "f", "f", "f", "f", "f", "f", "f", "f", "f", "f", "f", "f", "f", "f", "f", "f", "f", "f", "f", "f", "f", "f", "f", "f", "f", "f", "f", "f", "f"],
        ["f", "f", "f", "f", "f", "f", "f", "f", "f", "f", "f", "f", "f", "f", "f", "f", "f", "f", "f", "f", "f", "f", "f", "f", "f", "f", "f", "f", "f", "f", "f", "f"],
        ["f", "f", "f", "f", "f", "f", "f", "f", "f", "f", "f", "f", "f", "f", "f", "f", "f", "f", "f", "f", "f", "f", "f", "f", "f", "f", "f", "f", "f", "f", "f", "f"]
    ],
    [
        [" ", " ", " ", " ", " ", " ", " ", " ", " ", " ", " ", " ", " ", " ", " ", " ", " ", " ", " ", " ", " ", " ", " ", " ", " ", " ", " ", " ", " ", " ", " ", " "],
        [" ", " ", " ", " ", " ", " ", " ", " ", " ", " ", " ", " ", " ", "l", " ", " ", " ", " ", " ", " ", " ", "e", "e", " ", " ", " ", " ", " ", " ", " ", " ", " "],
        [" ", " ", " ", " ", " ", " ", " ", " ", " ", " ", " ", " ", " ", "l", "f", "f", "f", "f", "f", "f", "f", "f", "f", "f", "f", "f", "f", "f", "f", "f", "f", "f"],
        [" ", " ", " ", " ", " ", " ", " ", " ", " ", " ", " ", " ", " ", "l", " ", " ", " ", " ", " ", " ", " ", " ", " ", " ", " ", " ", " ", " ", " ", " ", " ", " "],
        [" ", " ", " ", " ", " ", " ", " ", " ", " ", " ", " ", " ", " ", "l", " ", " ", " ", " ", " ", " ", " ", " ", " ", " ", " ", " ", " ", " ", " ", " ", " ", " "],
        [" ", " ", " ", " ", " ", " ", " ", " ", " ", " ", " ", " ", " ", "l", " ", " ", " ", " ", " ", " ", " ", " ", " ", " ", " ", " ", " ", " ", " ", " ", " ", " "],
        [" ", " ", " ", " ", " ", " ", " ", " ", " ", " ", " ", " ", " ", "l", " ", " ", " ", " ", " ", " ", " ", " ", " ", " ", " ", " ", " ", " ", " ", " ", " ", " "],
        [" ", " ", " ", " ", " ", " ", " ", " ", " ", " ", " ", " ", " ", "l", " ", " ", " ", " ", " ", " ", " ", " ", " ", " ", " ", " ", " ", " ", " ", " ", " ", " "],
        [" ", " ", " ", " ", " ", " ", "e", " ", " ", " ", " ", " ", " ", "l", " ", " ", " ", " ", " ", " ", " ", " ", " ", " ", " ", " ", " ", " ", " ", " ", " ", " "],
        ["f", "f", "f", "f", "f", "f", "f", "f", "f", "f", "f", "f", "f", "l", " ", " ", " ", " ", " ", " ", " ", " ", " ", " ", " ", " ", " ", " ", " ", " ", " ", " "],
        [" ", " ", " ", " ", " ", " ", " ", " ", " ", " ", " ", " ", " ", "l", " ", " ", " ", " ", " ", " ", " ", " ", " ", " ", " ", " ", " ", " ", " ", " ", " ", " "],
        [" ", " ", " ", " ", " ", " ", " ", " ", " ", " ", " ", " ", " ", "l", " ", " ", " ", " ", " ", " ", " ", " ", " ", " ", " ", " ", " ", " ", " ", " ", " ", " "],
        [" ", " ", " ", " ", " ", " ", " ", " ", " ", " ", " ", " ", " ", "l", " ", " ", " ", " ", " ", " ", " ", " ", " ", " ", " ", " ", " ", " ", " ", " ", " ", " "],
        [" ", " ", " ", " ", " ", " ", " ", " ", " ", " ", " ", " ", " ", "l", " ", " ", " ", " ", " ", " ", " ", " ", " ", " ", " ", " ", " ", " ", " ", " ", " ", " "],
        [" ", "p-", " ", "s", " ", " ", " ", " ", " ", " ", " ", " ", " ", "l", " ", " ", " ", " ", "e", " ", "e", " ", " ", " ", " ", "e", " ", " ", " ", " ", " ", " "],
        ["f", "f", "f", "f", "f", "f", "f", "f", "f", "f", "f", "f", "f", "f", "f", "f", "f", "f", "f", "f", "f", "f", "f", "f", "f", "f", "f", "f", "f", "f", "f", "f"],
        ["f", "f", "f", "f", "f", "f", "f", "f", "f", "f", "f", "f", "f", "f", "f", "f", "f", "f", "f", "f", "f", "f", "f", "f", "f", "f", "f", "f", "f", "f", "f", "f"],
        ["f", "f", "f", "f", "f", "f", "f", "f", "f", "f", "f", "f", "f", "f", "f", "f", "f", "f", "f", "f", "f", "f", "f", "f", "f", "f", "f", "f", "f", "f", "f", "f"]
    ]
    
]